.....#######..........
.....#-----#..........
.....#-----#..........
.....##--###..........
......#--#............
#######--#####........
#------------#........
#-##-##------#........
#-##-##--#--##........
#--------#--#.........
#-##-##--#--####......
#-##-##--#-----#......
#--------#-----#......
####--####-----#......
.#-----#############..
.#-----#---#---#---#..
.#-----#---#---#---#..
.###--##---#---#---#..
...#--###-###-###-####
...#-----------------#
...##----------------#
....##################